0 0 0 0 0 0 0 0 0 0 0 0 0
9 9 9 9 9 0 9 9 9 9 9 9 9
9 1 1 1 9 0 9 2 2 2 2 2 9
9 1 1 1 9 0 9 2 2 2 2 2 9
9 1 1 1 9 0 9 9 9 9 9 9 9
9 9 9 9 9 0 0 0 0 0 0 0 0
0 0 0 0 0 0 9 9 9 9 9 9 9
9 9 9 9 9 0 9 3 3 3 3 3 9
9 4 4 4 9 0 9 3 3 3 3 3 9
9 4 4 4 9 0 9 3 3 3 3 3 9
9 9 9 9 9 0 9 9 9 9 9 9 9