0 0 0 0 0 0 0 0 0 0 0 0 0
9 9 9 9 1 0 9 9 9 9 9 9 1
9 1 1 1 1 0 9 2 2 2 2 2 1
9 1 1 1 1 0 9 2 2 2 2 2 1
9 1 1 1 9 0 9 9 9 9 9 9 1
9 9 9 9 9 0 0 0 0 0 0 0 0
0 0 0 0 0 0 1 1 9 9 1 1 1
1 1 1 1 9 0 9 3 3 3 3 3 1
1 4 4 4 1 0 9 3 3 3 3 3 1
1 4 4 4 9 0 9 3 3 3 3 3 1
0 0 0 0 0 0 0 0 0 0 0 0 9
