0 0 0 1 1 1 1 1 1 1 0 0 0
0 0 1 1 2 2 2 2 2 1 1 0 0
0 0 9 9 9 9 9 9 9 9 9 0 0
0 0 0 0 0 0 0 0 0 0 0 0 0
0 0 3 3 3 0 0 0 3 3 3 0 0
0 0 0 0 0 0 0 0 0 0 0 0 0
0 4 4 4 4 4 4 4 4 4 4 4 0
0 0 0 0 0 0 0 0 0 0 0 0 0
9 9 5 5 5 9 9 9 5 5 5 9 9
6 6 6 6 6 6 6 6 6 6 6 6 6