9 9 9 9 9 9 9 9 9 9 9 9 9
9 3 3 3 3 3 3 3 3 3 3 3 9
9 3 2 2 2 2 2 2 2 2 2 3 9
9 3 2 1 1 1 1 1 1 1 2 3 9
9 3 2 2 2 2 2 2 2 2 2 3 9
9 3 3 3 3 3 3 3 3 3 3 3 9
9 9 9 9 9 9 9 9 9 9 9 9 9