9 9 9 9 9 9 9 9 9 9 9 9 9
9 1 1 1 9 2 2 2 9 3 3 3 0
0 1 9 1 9 2 9 2 9 3 9 3 9
0 1 9 1 9 2 9 2 9 3 9 3 0
0 1 1 1 9 2 2 2 9 3 3 3 0
9 9 9 9 9 9 9 9 9 9 9 9 9
9 4 4 4 9 5 5 5 9 6 6 6 0
9 4 9 4 9 5 9 5 9 6 9 6 9
9 4 4 4 9 5 5 5 9 6 6 6 9
0 0 9 0 9 9 0 9 9 0 9 0 0